11111111111111111
10P00000E000000C1
11111111111111111
