1111111111111111111111111111
1P0000000001N000000000000001
111111111101N011111111111N01
1C000000CN000001C00NCN000001
1C01110N0N1111N1000NCN001101
1N0N010N0N1N0001000NCN00NN01
1000011NCN1E0101000000001101
10111111N111110111111111N001
101000000000000N000000100001
100111100111N111111111101101
1N00000011000010010C0N101101
1C111101000N0N000N0100101101
1C0000000NC0C00NCCC1N00011N1
1111111111111111111111111111
