11111111
10P00C01
100C00E1
11111111