111111111111111111111111111
1C0100000000000000000000001
100000000000000000C00000001
100000010001000000110000001
10N000000000000000000000001
1000000000001000000000C0001
100000010000000000C00000001
10P00000000000E000000000001
100000000000000000000000001
100000000010000000110000001
1000C00000000000000000C0001
100000000001000000010000001
10000000000000C000000000001
1C000N000000000000000000001
111111111111111111111111111
