111111111111111111111111111111111111111111111111111111111111111111111111111111111111111111111
100000000000000000000000000000000000000000000000000000000000000000000000E00000000C000000P0001
111111111111111111111111111111111111111111111111111111111111111111111111111111111111111111111